*--*---*o*---*--*
-oo-ooo-o-ooo-oo-
-oo-ooo-o-ooo-oo-
*--*-*-*-*-*-*--*
-oo-o-ooooo-o-oo-
*--*o*-*o*-*o*--*
ooo-ooo-o-ooo-ooo
ooo-o*-*-*-*o-ooo
ooo-o-ooooo-o-ooo
*--*-*ooooo*-*--*
ooo-o-ooooo-o-ooo
ooo-o*-----*o-ooo
ooo-o-ooooo-o-ooo
*--*-*-*o*-*-*--*
-oo-ooo-o-ooo-oo-
**o*-*-*-*-*-*o**
o-o-o-ooooo-o-o-o
**-*o*-*o*-*o*-**
-oooooo-o-oooooo-
*------*-*------*